6
2,2
f
3 2 1 1 2 2
2 3 3 4 4 4
1 2 2 3 3 3
6 1 1 4 4 2
3 4 5 5 4 5
2 2 2 3 3 3