6
2,3
25
60
t
15,1
10,2
f
3 2 1 1 2 2
2 3 3 5 4 4
1 2 2 6 3 3
6 1 1 7 4 2
3 4 5 5 4 5
2 1 2 3 1 3